v1
:name escape1
:layers
00000000111110
00000000111111
11100000111111
11100000111111
11100000111111
00000000111111
00000000111111
00000000111110
00000000111100
00000000110000
---
00000000004400
00000000044000
00000000040440
03000000044440
00000000404044
00000000044440
00000000004400
00000000000000
00000000000000
00000000000000
---
00000000000000
00000000000000
00000000000000
00000000000000
00000000000200
00000000000000
00000000000000
00000000000000
00000000000000
00000000000000