v1
:name tuto_jump
:layers
00000011060
00000000000
11111111111
11111111111
11111111111
00000000000
01111000000
---
00000000000
00000000000
00050005000
00050005030
00050005000
00000000000
00000000000
---
00000000000
00000000000
00000000000
02000000000
00000000000
00000000000
00000000000