v1
:name tuto_push
:layers
11111111111
11111111111
11111111111
---
00050004000
00050005030
00040005000
---
00000000000
02000000000
00000000000