v1
:name tuto_sink
:layers
11111011111
11111011111
11111011111
---
00050000000
00050005030
00040005000
---
00000000000
02000000000
00000000000