v1
:name tuto_move
:layers
11111111111
11111111111
11111111111
---
00050000000
00050005030
00000005000
---
00000000000
02000000000
00000000000