v1
:name bridge1
:layers
011111000000000000
011111000000000000
111111000000000111
111111000000000111
111111000000000111
011111000000000000
011111000000000000
---
000000000000000000
000040000000000000
000444000000000000
000004000000000030
000400000000000000
000440000000000000
000000000000000000
---
000000000000000000
000000000000000000
000000000000000000
020000000000000000
000000000000000000
000000000000000000
000000000000000000