v1
:name jump1
:layers
111000060000
111011001106
111000010000
000006006001
000000060101
111001101000
111000010000
111060110000
---
000000000000
000000000000
000000000000
000000000000
000000000000
000000000000
030000000000
000000000000
---
000000000000
020000000000
000000000000
000000000000
000000000000
000000000000
000000000000
000000000000