v1
:name heart
:layers
601111100
000111000
000010010
011000110
110101111
106011111
010011110
001111100
000111000
000010000
---
000000400
000000000
000000000
040000000
400000000
000050300
000005000
000045000
000500000
000000000
---
000000000
000000000
000000000
000000000
000000000
000000000
000000000
000000000
000000000
000020000